{"levels": {
"name": "revenge",
"total": 17,
"level-001": [
"H@    SSS   SS   SS  SSS   @",
"H@   S     S  S S  S S  S  @",
"H@   S  SS S  S S  S S  S  @",
"H@   S   S S  S S  S S  S  @",
"H@    SSS   SS   SS  SSS   @",
"H@@@@@@@@@@@@@@@@@@@@@@@@@@@",
"H                           ",
"H########@##############-   ",
"H##H####@H ##H##  #H#H##-@H ",
"H##H####@H###H#H#####H##-@H&",
"H##H#$$#@H$##H#H##$##H##-@H0",
"H##H####@H ##H#H#####H##-@H ",
"H#@#H  $@@H H@#@#####H@#-@H ",
"H@@@@@@@@@@@@@ @@@@@#@@ -@H ",
"H00                  $   @H ",
"######################## ## "],
"level-002": [
"S@                        @ ",
"S@                    $   @ ",
"S@H###H-H$H$H$H$H$H-H####H@ ",
"S@H      H$H$H$H$H     $ H@ ",
"S@H###H---H$H$H$H---H####H@ ",
"S@H        H$H$H     $   H@ ",
"S@H###H-----H$H-----H####H@ ",
"S@H   $$$$$$$H$$$$$$$$   H@ ",
"S@@##########H########XXX@@ ",
"S            H              ",
"S  ######    H    ######    ",
"S  ##$$##    H    ##$$##    ",
"S  ######    H    ######    ",
"S            H              ",
"S   &        H       $     0",
"@@@@@@@@@@@@@@@@@@@@@@@@@@@@"],
"level-003": [
"                          @S",
"         -------          @S",
"#########       H         @S",
" ##$$$##    $$  H   $     @S",
"  #####   -##############H@S",
"   ###    -         ####HH@S",
"    #     -         #$#HH#@S",
"         -          ##HH##@S",
"        - $         #HH###@S",
"       - $$   $    $HH####@S",
"$     - $$$  ###H#########@S",
"###X##  $$$     H         @S",
"   H    ####    H         @S",
"   H            H         @S",
"$  H      & $   H   $    00S",
"###H###S####################"],
"level-004": [
"                            ",
"       H@$          H@$     ",
"  -H@$ H@@$         H@@$    ",
"   H@X H@@XH@$      H@@@$   ",
" $ H  $H   H@@$     H@@@@$  ",
" X#########H@@@$    H@@@@@$ ",
"  ###$$$## H@@@@    H@@@@@@$",
"   ######  H@@@@X   H@@@@@@X",
"           H        H       ",
"       $   H  $$$   H $$$$  ",
"      #####################H",
"        ##   #$$$@$$$  - ##H",
"         ###  $$$@$$HX# ## H",
"           ###@@@@@@@###   H",
"  000   $$   $   $ $      &H",
"  @@@@@@@@@@@@@@@@@@@@@@@@@H"],
"level-005": [
"@         S                @",
"@         S                @",
"@@@@@@@@@@S@@@@@@@@@@@@@@@@@",
"@@@@@@@@@@SSSSSSSSSSSSSSSS @",
"@ $  $     $  $$      $ $$H@",
"@H#########################@",
"@H                     0000@",
"@#########################H@",
"@  $             $ $$$    H@",
"@H#########################@",
"@H           $           $ @",
"@#########################H@",
"@     $  $    $$         $H@",
"@H@@@@@@@@@@@@@@@@@@@@@@@@@@",
"@H                    $  $$&",
"@@@@@@@@@@@@@@@@@@@@@@@@@@@@"],
"level-006": [
"@S@@@@@@@@@@@@@@@@@@@@@@@@@@",
"@S -------------------     @",
"@S     H              H $  @",
"@X#XXXXH              ####H@",
"@      H  ########        H@",
"@      H #HHHHHHHH#       H@",
"@XXXXXXH#HH $$$$ HH#      H@",
"@$X X$XH#H  ----  H#      H@",
"@$X$X$XH#H        H#      H@",
"@$X$X$XH XH ---- H#       H@",
"@$X$X$XH--##XXXX##        H@",
"@ X$X XH                  H@",
"@XXXXXXH                  H@",
"@------H             00$$&H@",
"@####### ###########S######@",
"   $$$              S       "],
"level-007": [
"   ------------------------H",
"  -     H H - 00  - $$$$$$ H",
" & -    H-$  -00  - $$$$$ -H",
"  ---     H   $$  H $$$$ --H",
"     -    H - $$  $ $$$ ---H",
"      -   H -   - H $$ ----H",
"     - -  H -    -    -----H",
"    -   - H $    $  --  $  H",
" $ -     -H----- -$-    $  H",
" H-       H -   - H-    $  H",
" H -      H -  -  H-    $  H",
"    -     H-- -         $  H",
"     -    H  - -------- $  H",
"      -   H -   - -- -  $  H",
"       ---H-     -  -   $  H",
"          H                H"],
"level-008": [
"S#                         #",
"S#         $$              #",
"S# #########################",
"S#0--- ###  $  ---    --    ",
"S##H #H  # ####   H  -  ###H",
"S## ####H#        H-- ##-XXH",
"S##$$$$#H    $     0  ##$XXH",
"S######################X##XH",
"S# ------------------------H",
"S#H#######X#######X##H######",
"S#H# 0 $    #      $ H#     ",
"S#H# ######H# #######H# ###H",
"S#H  #  $ #H  #  $  #H  #  H",
"S##### H# ##### H#  ##### H#",
"S$    &H#    $ 0H#        H#",
"############################"],
"level-009": [
" 0 -----------            @S",
"H##$ @@@@@@@ $##H      @S @S",
"H###$ @@@@@ $###H      @@@@S",
"H####$ @@@ $####H     $0  @S",
"H#####$ @ $########H#####H@S",
"H######$ $######   H    #H@S",
"H#######$#######$       #H@S",
"H####################H###H@S",
"H$     @H@    0      H  #H@S",
"######H@H@  #######H   $#H@S",
"      H@H@  ######$######H@S",
"H######@H@$ ###$#  # $  #H@S",
"H##$###@H@###############H@S",
"H     &@H@   $         $ H@S",
"@@@@@@@@H@@@@@#@@@@@@@@@@@@S",
"        H     $ $          S"],
"level-010": [
"S                           ",
"S----    ------------------ ",
"H   S@S H  $-  $  - $ -  $  ",
"H   S@H H  $ - H -  H  - H  ",
"H $0S@H H -H---H----H----H $",
"H###S H H- - - - -- - -- -  ",
"H$  S@H H          $     00 ",
"H###S@H  #############H#####",
"H  $S@H  ######       H     ",
"H###S H  ######       H  $  ",
"H $ S@H  ######    H####H###",
"H###S@H  ###$##    H#   H   ",
"H  #S@H  ######    H# $    $",
"##H#S@H        H############",
"& H#S@H        H     $   $00",
"####S@H  H##################"],
"level-011": [
"# ##########################",
"#S ##                      #",
"##S #  H#######H-----      #",
"###S#  H####$##S    S#H#S$ #",
"###S $ H#$#####S $  S#H#####",
"######################H     ",
"                     ######H",
"----#H  $ ####H            H",
"    #H###H####H    $       H",
"$   #H   H##$#H########H####",
"    #H $ H    $        H  $ ",
" $  ##############H $  H###H",
"   $           $  H####H $ H",
"             H######   H####",
"       $    &H        0H0000",
"S###########################"],
"level-012": [
"S                           ",
"S                 $ ------- ",
"S              @@@@@$      H",
"@@@S          @HHHHH@$     H",
"@  S         @HH $ HH@$    H",
"@ @@@@@H@@@@XHH0$$$ HHX$   H",
"@ @  $ H@   @@@@#@@@@@@    H",
"@$@H@@@@@     --- @        H",
"@$@H@            H@ ###### H",
"@$@H@  $  $      H@ ###### H",
"@$@H@@@@@@@@@@   H@ ###### H",
"@$@H-------- @ $ H@ ##$### H",
"@ @H $ $$ $ H@@@#@@ ###### H",
"@ @H@@@#@@@@@@  $   ###### H",
"@ &H   0000   @@@@         H",
"@@@@@@@@@@@H             H@@"],
"level-013": [
"@@@@@@@@@@@@@@@@@@@@@@@@@@ @",
"@  ---------              S@",
"@ #        $H#####S      S @",
"@$#        H#----#S     S  @",
"@$#       H$    HH##S  S   @",
"@$#     -$H#H    HH#S S    @",
"@$#    H$#H#H     H########@",
"@$     H##H#H $$  H#   $$  @",
"@$#   $H#  #########H#####$@",
"@$#H##### $# -------H# $ #$@",
"@$#H#   ####H     $      #$@",
"@$#H# $  $  #H#######H####$@",
"@ #H#        H       H  $# @",
"@ #H###H########H#########H@",
"@ &H   H    $$  H    $0000H@",
"@#@@#@#@###@@##@@#@@#@###@@@"],
"level-014": [
"S                           ",
"S                           ",
"$##########################H",
"$# -------------H---------#H",
"$#H $    $  $   #H        @H",
"$#H   H########H##H ##### @H",
"$#XH  H $      H #H  ##$# @H",
"$#X#H#####   $ H ##H  ### @H",
"$#$#H    #H####H $##HH ## @H",
"$#$#H $  #H     H#####H # @H",
"$# #####H#H   $ H    ##H  @H",
"$#   $  H##H####H  $  #H  @H",
" #H#####H# H    H#######H @H",
"$#H0000    H $  H    $&##H@H",
"$##########################H",
"                           H"],
"level-015": [
"                           S",
"   $            $          S",
"H#########-H#########H     S",
"H          H         H $   S",
"H     $     ------   ####XXH",
"##H########                H",
"  H               H#########",
"  H $             H#########",
"H########H   $    H####$####",
"H        H##################",
"H  $     H                  ",
"####H######################H",
"####H#$$$$ $$ $ $$  $$$$$  H",
"#$##H#######################",
"####H00000                 &",
"############################"],
"level-016": [
"S  #########################",
"S& #  # ------ ############ ",
"H@ #H# H #### -      0     X",
"H@0#H#H#H    H @###########$",
"H@ #H#######H  $@#####-#####",
"H@ #H#$####H#H @######-####$",
"H@ #H#####H@#H   ###$#-#$###",
"H@ #H  # H######H ####X####$",
"H@ ###H#$H##  $ H         ##",
"H@   #H#X##########@       $",
"H@ ###H     #H#####@ H#@@#H#",
"H@ #H####H$ #H# $  @ H# $#H$",
"H@ #H    H#######SS####X####",
"H#X#######@@@@@@@@@@@@@@@#@@",
"H                      000  ",
"H@#@#@#@#@#@#@#@#@#@#@#@#@#@"],
"level-017": [
"                   #        ",
" ############H#S   #        ",
"H#@ $$   0  #H######  H###X#",
"H#@###@@@##H#H       H@#$H #",
"H#@- #$$  #H#H  &   H@@##H #",
"H#@ ####H #H#######H --###X#",
"H#@@#$$ H #H      #H   @  $ ",
"H#@@##### #######H###H @@@@#",
"H#@$            #H#  H      ",
"H####        $   H#  H   H# ",
"H#   H#####@@@@@@##H#####H##",
"H#   H#  #H@@      H# # #H#$",
"H##  H#0 #H@@H####### $ #H #",
"##H###### #@@H#     ###X#H# ",
"##H#    #    H# $       #H#$",
"##H#$$$  ######X############"]
}}
